##################
#................#
#....TTTTTTTT....#
#................#
#....%%%%%%%%....#
#................#
#....TTTTTTTT....#
#................#
#....%%%%%%%%....#
#................#
#....TTTTTTTT....#
#................#
#....%%%%%%%%....#
#................#
##################