4 5 9 8
################
#..............#
#..............#
#..............#
#....>.........#
#..............#
#..............#
#..............#
#..............#
#.......<......#
#..............#
#..............#
################