################
#..#############
#..#############
#..#############
#..##..#########
#..++..#########
#..##..##..#####
#####..++..##..#
#####..##..++..#
#########..##..#
################