1 1 9 13
################
#>.#############
#..#############
#..#############
#..##..#########
#..++..#########
#..##..##..#####
#####..++..##..#
#####..##..++..#
#########..##<.#
################