1 1 13 16
##################
#>...............#
#....TTTTTTTT....#
#................#
#....%%%%%%%%....#
#................#
#....TTTTTTTT....#
#................#
#....%%%%%%%%....#
#................#
#....TTTTTTTT....#
#................#
#....%%%%%%%%....#
#...............<#
##################